1,1,1,1,1,1,1,1,1,1,1,1,1,1,1,1,1,1,1,1,1,1,1
1,0,0,0,0,0,0,0,0,0,0,0,0,0,0,0,0,0,0,0,0,0,1
1,0,0,0,0,0,0,0,0,0,0,0,0,0,0,0,0,0,0,0,0,0,1
1,0,0,1,0,0,0,0,0,0,0,o,0,0,0,0,0,0,0,1,0,0,1
1,0,0,0,2,2,2,0,2,0,2,0,2,0,2,0,2,2,2,0,0,0,1
1,0,0,0,2,2,0,2,0,2,0,2,0,2,0,2,0,2,2,0,0,0,1
1,0,0,0,2,y,2,t,2,0,2,1,2,0,2,t,2,y,2,0,0,0,1
1,0,0,0,0,2,0,2,0,2,0,2,0,2,0,2,0,2,0,0,0,0,1
1,0,0,0,2,0,2,0,2,0,2,0,2,0,2,0,2,0,2,0,0,0,1
1,0,0,0,0,2,0,2,0,2,2,2,2,2,0,2,0,2,0,0,0,0,1
1,0,0,0,2,0,2,0,2,2,2,2,2,2,2,0,2,0,2,0,0,0,1
1,0,c,0,0,2,1,2,0,2,2,m,2,2,0,2,1,2,0,0,0,0,1
1,0,0,0,2,0,2,0,2,2,2,2,2,2,2,0,2,0,2,0,0,0,1
1,0,0,0,0,2,0,2,0,2,0,2,0,2,0,2,0,2,0,0,0,0,1
1,0,0,0,2,0,2,0,2,0,2,0,2,0,2,0,2,0,2,0,0,0,1
1,0,0,0,0,2,0,2,0,2,0,2,0,2,0,2,0,2,0,0,0,0,1
1,0,0,0,2,y,2,o,2,0,2,1,2,0,2,o,2,y,2,0,0,0,1
1,0,0,0,2,2,0,2,0,2,0,2,0,2,0,2,0,2,2,0,0,0,1
1,0,0,0,2,2,2,0,2,0,2,0,2,0,2,0,2,2,2,0,0,0,1
1,0,0,1,0,0,0,0,0,0,0,t,0,0,0,0,0,0,0,1,0,0,1
1,0,0,0,0,0,0,0,0,0,0,0,0,0,0,0,0,0,0,0,0,0,1
1,0,0,0,0,0,0,0,0,0,0,0,0,0,0,0,0,0,0,0,0,0,1
1,1,1,1,1,1,1,1,1,1,1,1,1,1,1,1,1,1,1,1,1,1,1
150,250,400,400,800